7
8
0
0
S#DFFFFL
T#T####T
T#T#EL#T
T#T##YFK
T#BFFC#T
T######T
BFFFFFFC