9
10
1
1
##########
#S#DFFFFL#
#T#T####T#
#T#T#HD#T#
#T#T##TFK#
#T#BFFC#T#
#T######T#
#BFFFFFFC#
##########
